国象联赛第11轮对阵：浙江遭遇山东 上海对决重庆
　　新浪体育讯　第11轮详细对阵如下：
　　广东深圳华腾国际象棋俱乐部队 - 蓝珀通信江苏国际象棋队
　　梁金荣 : 韦奕
　　梁充 : 周唯奇
　　李师龙 : 徐俊
　　黎清秀 : 沈阳
　　邝颖慧 : 郭琦
　　上海建桥学院国际象棋队 - 重庆移动通信国际象棋队
　　楼一平 : 莫蒂列夫
　　周健超 : 高睿
　　倪华 : 王晨
　　章晓雯 : 谭中怡
　　居文君 : 黄茜
　　天津南开大学国际象棋队 - 北京爱国者国际象棋队
　　刘庆南 : 李超
　　李昊宇 : 修德顺
　　马群 : 余泱漪
　　宁春红 : 赵雪
　　蔡佳莹 : 王珏
　　北京人大附中国际象棋队 - 河北国际象棋队
　　余瑞源 : 王皓
　　曾重生 : 张鹏翔
　　杨凯淇 : 万云国
　　徐若颖 : 王豆豆
　　李雪怡 : 翟墨
　　浙江国际象棋队 - 山东玲珑轮胎国际象棋队
　　卢尚磊 : 卜祥志
　　俞烈 : 温阳
　　丁立人 : 赵骏
　　许昱华 : 张继林
　　丁亦昕 : 侯逸凡

